    ##########
    #        #
    #   ######
    #        #
    #        #####
    #    X XOO   #
    #          P #
    ##############
